                                                                                
                                                                                
################################################################################
#...............;.......^....,,,,,,,,,,,..^..,,,,,,,,,,,.......^,,,,,,,,,,,,,,,#
#...............;.....,,,,,,,,,,,......^^^,,,,...^.....^...^...^,,,,,,,,,,,,,,,#
#;;.,,,,,,,.^...;..,,,,^,,,^,........^^^.^^^...^....^....^.....^;;;;;.,,,,;;,,,#
#..;........^,,,;,,,^,....^........^^^.,,,.^^^...^.....^...^...^..,,,,,,,,,,,..#
#.,,;,,,;,,.^,,,;,,,,,...^.......^^^..^.^.^..^^^.,,,,,,,..^....^..,,;;;;;,,,,..#
#...;,,,,,,.^,,,,,,,,,,,,,,...^^^^.....^,,,,,..^^^..^...^......^....;,,,,,,,,..#
#....;,,;,,.^;;;;;;;;;;;;;;..^^^.^..^.....^..^.^^^^^...^...^...^,,,,;,,,,,,,...#
#.,,,,;,;...^,,,,,,,,,,,,,,^^^...^...^.^.^...^.....^^^...^.^...^,,,,;;,,,,,,...#
#..;,,,;.;..^.;;;;;;;;;;;;^^^....^.^.,,,,^...^.;...;.^^^...^...^...,,,;,,,,,...#
#...;,,,,,..^,,,,,,,,,,,^^^~~~=......^...^...^.;...;...^^^.....^....,,,;,,,,,..#
#...........^;;;;;;;;..^^^~...=~~~.,,,,,.^....^^^,,;,,,,,^^^..^^.;;;;...;......#
#...;.,,,,,,^,,,,,,,,^^^~.......~~~~....^....^^^,,,;,,,,,,,^^^.,,,,,,,,,,;,,,,.#
#.....;.,,,,^††....^^^~....,,,...~~~.......^^^.,,,,;,...,,,..^^^....,,,,,,;,,,,#
#.....,,,,,,^††..^^^~..^^.^...^...~~~~...^^^..^.,,,;,,,,,,.....^^^.....,,,,,,,,#
#.;..;;..;..^..^^^~~~.^.^.,.^....^..~~~^^^......,,,;,,;;.........^^^......,,,,,#
#.;,,,,,.....^^^....~~~...^..^..,,...^^^....^...,,,;...;;;...;;....^^^;;;;.....#
#.,,,,,,...^^^.,,,,;..~~~~..^...^..^^^..^.^...^.,,,;..;;;.....,,,,,,,^^^,,,,,,,#
#.,,,,,,.^^....,,,,;...~~~.^^.,,.^^^..^...^...,,,,,;.;......,,,,,,,,,..^^^..;;;#
#.;....^^^...,,,,,,;,..~~~.....^^^..^...^..,^,,,,,,;;.........;..........^^^...#
#.;..^^^,,,,..,,,,,;,,.===...^^^^...^.^......,,,,,,;.,,,,,..;.,;,;,;,;,;...^^^.#
#..^^^.,,,,,.,;;;,,;,,..~~~^^^..^^....^.^...^.^,,,,;..,,,,.....,,,,,,,,,,..;;,.#
#....^^^.,,,..;©;..;.....^^^;....^^^.......^..^.,,,;..,,,,,;;..,,^,,,,....;;.,.#
#......^^^....;.;..;...^^^,,;......^^^......,,,,,,,;....,,,....,.^.......;;.,,.#
######...^^^.;;.;..;.^^^.,,,;........^^^.....^,,,,,;......;;;..,,^,,,...;;...;.#
#..........^^^..;..^^^^,,,,,;.;;;;;;;,,^^^..,,,,,,,;........;..........;;..,,,.#
#....#...;...^^^.^^^..^,,^,,;,,,,,,,;.,,,^^^..^.....;;,,,,,,;,,,,,,,..;;.,,^,,.#
#....#.,,;,,,..^^^..,,^,,^,,;;;;;,,,;,,,,..^^^.......;,,,,,,;........;;,;,.....#
#®...#.,,,,,,............^.,,,,,,,,,;,,,.........^....;.....;.......;,,,,..^...#
################################################################################
