################################################################################
#:::~::...###........##¬¬¬¬¬####...............^^^..................#####::©:::#
#..:::...##...########¬#####¬###¬.......^^....^^.................#######::::::##
#......######.#¬¬¬¬##¬#######¬¬¬####...^^^^^^...................,,;######::::###
#...####.#¬¬¬¬¬¬##¬¬¬####.##################^^^^^^...........,,,,;...#####::####
#.......¬¬¬###########....................^^^^^^^^^^^......,,,,,,;,,...####:####
#.....######.............~~~~~~~~~~~~~~~~~........^^^^^^^.....,,;,,,..#####..###
#....#####....~~~~~~~~~~~~~~~~~~~~~~~~~~~~~~~~~~~~.....^^^^^............###...##
#..........~~~~~~~~~~~~~~~~~~~::::::,,,;~~~~~~~~~~~~~~=~~^^^^^^...........###..#
#........~~~~~~~~:::::::::::::::::::,,,;;;;;;;;;;~~~~~=~~~~~~~^^^...........#..#
#.....~~~~~~::::::::::::::::::::::::::,,,,,,;;;;;;;;;;=~~~~~~~~~~~~~~..........#
#~~~~~~~~~:::::::::;::::::::::::::^^:::::::::::,,,;;;;,;;;~~~~~~~~~~~~~~~~~~...#
#~~~~~~~:::::::::::::::::::::^^^^^^^^^^::::::::::,,;;;,;;;;;;;;;;~~~~~~~~~~~~~~#
#~~~~~~~::::::::::::::,,,,^^^^^^^^^^^^^^^^^^:::::::,;;,,,,,,,;;;;;;~~~~~~~~~~~~#
#.,~~~~~~=::::::::::::::,,,,,,^^^^^^^^^^,,,,,:::::,,,;;;;;;;,;,,,,;~~~~~~~~~~~~#
#.,,,,~~~=~~:::;::::::::::,,,,,,^^^^^^,,,,,,,::::::::,,,,,,,,,,~~~=~~~~~~~:††::#
#...,,,,~=~~~~::::::::::::::,,,,,,,^,,,,,,,:::::;::::::,,,~~~~~~~~=~##.::::††::#
#.....,,,=~~~~~~~:::::::::::::::::::;:::::::::::::::::~~~~~~~~~~...##....::::::#
#....#.......~~~~~~~~::::::::::::;::::::::::::::::~~~~~~~~~:::#.####......:::::#
#..###..........~~~~~~~~~~~~::;::::::::::::;:~~~~~~~~~::::.....#.......^^......#
########............~~~~~~~~~~~~::::::~~~~~~~~~~~~:::::..^...........^^........#
#.....###..........:####...~~~~~~~~~~~~~~~~~~~:::::....^^^^................,,,,#
#..###.............,,:####....~~~~~~~~~~~~~::::.........^^....#.....,,,,,,,,,..#
####...............,;,,.....,,,;,.....::::::::..............####..,,,,,,,,;,,,,#
##..........................,,;;,,..............^^.........###.,,,,,,;,,,,,,,;,#
#...........^^^^^^^.......,,,,,;,,...........^^^^.........##,,,,,,,;,,,,,,,;,,,#
#.....^^^^^^^^....^^^^^..^^.,,,;;.............^^.........,,,,,,,,,;,,;,,,;,,,,,#
#.....................^^^^^^..,,;,,..........................,,,,,;;;,,,,,,,,;,#
#..............................,,,,,.............................;,,,,,;,,,®,,,#
################################################################################